0000000000000000100
0000000000000000100
0000011111111000100
0000111111111100100
0001111111111110100
0011111111111111100
0011111111111111100
0011111111111111100
0011111111111111100
0011111111111111100
0011111111111111100
0111111111111111100
0000000000000000000
0000000000000000000
0000000000000000000